affright	category=verb	score=-0.5
afraid	category=adjective	score=-0.5
alarm	category=noun	score=-0.5
alarm	category=verb	score=-0.5
alarmed	category=adjective	score=-0.5
alert	category=verb	score=-0.5
anxious	category=adjective	score=-0.5
anxiously	category=adverb	score=-0.5
appal	category=verb	score=-0.5
appall	category=verb	score=-0.5
apprehension	category=noun	score=-0.5
apprehensive	category=adjective	score=-0.5
apprehensively	category=adverb	score=-0.5
apprehensiveness	category=noun	score=-0.5
atrocious	category=adjective	score=-0.5
awful	category=adjective	score=-0.5
awfully	category=adverb	score=-0.5
bashfully	category=adverb	score=-0.5
boding	category=noun	score=-0.5
browbeaten	category=adjective	score=-0.5
bullied	category=adjective	score=-0.5
chill	category=noun	score=-0.5
chill	category=verb	score=-0.5
chilling	category=adjective	score=-0.5
cliff-hanging	category=adjective	score=-0.5
coldheartedness	category=noun	score=-0.5
consternation	category=noun	score=-0.5
cowed	category=adjective	score=-0.5
cower	category=verb	score=-0.5
crawl	category=verb	score=-0.5
creep	category=verb	score=-0.5
creeps	category=noun	score=-0.5
cringe	category=verb	score=-0.5
cruel	category=adjective	score=-0.5
cruelly	category=adverb	score=-0.5
cruelty	category=noun	score=-0.5
dash	category=verb	score=-0.5
daunt	category=verb	score=-0.5
diffidence	category=noun	score=-0.5
diffident	category=adjective	score=-0.5
diffidently	category=adverb	score=-0.5
dire	category=adjective	score=-0.5
direful	category=adjective	score=-0.5
dismay	category=noun	score=-0.5
dismay	category=verb	score=-0.5
dread	category=adjective	score=-0.5
dread	category=noun	score=-0.5
dread	category=verb	score=-0.5
dreaded	category=adjective	score=-0.5
dreadful	category=adjective	score=-0.5
dreadfully	category=adverb	score=-0.5
fawn	category=verb	score=-0.5
fear	category=noun	score=-0.5
fear	category=verb	score=-0.5
fearful	category=adjective	score=-0.5
fearfully	category=adverb	score=-0.5
fearfulness	category=noun	score=-0.5
fearsome	category=adjective	score=-0.5
foreboding	category=noun	score=-0.5
fright	category=noun	score=-0.5
fright	category=verb	score=-0.5
frighten	category=verb	score=-0.5
frighten_away	category=verb	score=-0.5
frighten_off	category=verb	score=-0.5
frightened	category=adjective	score=-0.5
frightening	category=adjective	score=-0.5
frighteningly	category=adverb	score=-0.5
frightful	category=adjective	score=-0.5
grovel	category=verb	score=-0.5
hangdog	category=adjective	score=-0.5
hardhearted	category=adjective	score=-0.5
hardheartedness	category=noun	score=-0.5
heartless	category=adjective	score=-0.5
heartlessly	category=adverb	score=-0.5
heartlessness	category=noun	score=-0.5
hesitance	category=noun	score=-0.5
hesitancy	category=noun	score=-0.5
hesitantly	category=adverb	score=-0.5
hesitatingly	category=adverb	score=-0.5
hideous	category=adjective	score=-0.5
hideously	category=adverb	score=-0.5
horrendous	category=adjective	score=-0.5
horrible	category=adjective	score=-0.5
horribly	category=adverb	score=-0.5
horrid	category=adjective	score=-0.5
horridly	category=adverb	score=-0.5
horrific	category=adjective	score=-0.5
horrified	category=adjective	score=-0.5
horrify	category=verb	score=-0.5
horrifying	category=adjective	score=-0.5
horrifyingly	category=adverb	score=-0.5
horror	category=noun	score=-0.5
horror-stricken	category=adjective	score=-0.5
horror-struck	category=adjective	score=-0.5
hysteria	category=noun	score=-0.5
hysterical	category=adjective	score=-0.5
hysterically	category=adverb	score=-0.5
intimidate	category=verb	score=-0.5
intimidated	category=adjective	score=-0.5
intimidation	category=noun	score=-0.5
mercilessness	category=noun	score=-0.5
monstrously	category=adverb	score=-0.5
outrageous	category=adjective	score=-0.5
pall	category=noun	score=-0.5
pall	category=verb	score=-0.5
panic	category=noun	score=-0.5
panic	category=verb	score=-0.5
panic stricken	category=adjective	score=-0.5
panic struck	category=adjective	score=-0.5
panic attack	category=noun	score=-0.5
panicked	category=adjective	score=-0.5
panicky	category=adjective	score=-0.5
pitilessness	category=noun	score=-0.5
premonition	category=noun	score=-0.5
presage	category=noun	score=-0.5
presentiment	category=noun	score=-0.5
ruthlessness	category=noun	score=-0.5
scare	category=noun	score=-0.5
scare	category=verb	score=-0.5
scare away	category=verb	score=-0.5
scare off	category=verb	score=-0.5
scared	category=adjective	score=-0.5
scarey	category=adjective	score=-0.5
scarily	category=adverb	score=-0.5
scary	category=adjective	score=-0.5
self-distrust	category=noun	score=-0.5
self-doubt	category=noun	score=-0.5
shivery	category=adjective	score=-0.5
shuddery	category=adjective	score=-0.5
shy	category=adjective	score=-0.5
shyly	category=adverb	score=-0.5
shyness	category=noun	score=-0.5
stage_fright	category=noun	score=-0.5
suspense	category=noun	score=-0.5
suspenseful	category=adjective	score=-0.5
suspensive	category=adjective	score=-0.5
terrible	category=adjective	score=-0.5
terrified	category=adjective	score=-0.5
terror	category=noun	score=-0.5
timid	category=adjective	score=-0.5
timidity	category=noun	score=-0.5
timidly	category=adverb	score=-0.5
timidness	category=noun	score=-0.5
timorous	category=adjective	score=-0.5
timorously	category=adverb	score=-0.5
timorousness	category=noun	score=-0.5
trepid	category=adjective	score=-0.5
trepidation	category=noun	score=-0.5
trepidly	category=adverb	score=-0.5
ugly	category=adjective	score=-0.5
unassertive	category=adjective	score=-0.5
unassertively	category=adverb	score=-0.5
unassertiveness	category=noun	score=-0.5
uneasily	category=adverb	score=-0.5
unkind	category=adjective	score=-0.5
unsure	category=adjective	score=-0.5
worry	category=verb	score=-0.5
worrying	category=adjective	score=-0.5
threatening	category=adjective	score=-0.5
vicious	caregory=adjective	score=-0.5
forced	category=adjective	score=-0.5
force	category=verb	score=-0.5
alert	category=noun
terrifying	category=adjective	score=-0.5
