abhor	category=verb	score=-0.5
abhorrence	category=noun	score=-0.5
abominate	category=verb	score=-0.5
abomination	category=noun	score=-0.5
aggravate	category=verb	score=-0.5
aggravated	category=adjective	score=-0.5
aggravation	category=noun	score=-0.5
aggression	category=noun	score=-0.5
aggressive	category=adjective	score=-0.5
aggressiveness	category=noun	score=-0.5
amok	category=adverb	score=-0.5
amuck	category=adverb	score=-0.5
anger	category=noun	score=-0.5
anger	category=verb	score=-0.5
angered	category=adjective	score=-0.5
angrily	category=adverb	score=-0.5
angry	category=adjective	score=-0.5
animosity	category=noun	score=-0.5
animus	category=noun	score=-0.5
annoy	category=verb	score=-0.5
annoyance	category=noun	score=-0.5
annoyed	category=adjective	score=-0.5
annoying	category=adjective	score=-0.5
antagonism	category=noun	score=-0.5
avaricious	category=adjective	score=-0.5
bad blood	category=noun	score=-0.5
bad temper	category=noun	score=-0.5
baffled	category=adjective	score=-0.5
balked	category=adjective	score=-0.5
bedevil	category=verb	score=-0.5
begrudge	category=verb	score=-0.5
begrudging	category=adjective	score=-0.5
belligerence	category=noun	score=-0.5
belligerency	category=noun	score=-0.5
belligerent	category=adjective	score=-0.5
belligerently	category=adverb	score=-0.5
bitterness	category=noun	score=-0.5
bother	category=verb	score=-0.5
bothersome	category=adjective	score=-0.5
brood	category=verb	score=-0.5
chafe	category=noun	score=-0.5
choler	category=noun	score=-0.5
choleric	category=adjective	score=-0.5
class feeling	category=noun	score=-0.5
contemn	category=verb	score=-0.5
covet	category=verb	score=-0.5
covetous	category=adjective	score=-0.5
covetously	category=adverb	score=-0.5
covetousness	category=noun	score=-0.5
crucify	category=verb	score=-0.5
dander	category=noun	score=-0.5
despisal	category=noun	score=-0.5
despise	category=verb	score=-0.5
despising	category=noun	score=-0.5
despiteful	category=adjective	score=-0.5
detest	category=verb	score=-0.5
detestation	category=noun	score=-0.5
devil	category=verb	score=-0.5
discouraged	category=adjective	score=-0.5
disdain	category=verb	score=-0.5
displease	category=verb	score=-0.5
displeased	category=adjective	score=-0.5
displeasing	category=adjective	score=-0.5
displeasingly	category=adverb	score=-0.5
displeasure	category=noun	score=-0.5
dudgeon	category=noun	score=-0.5
dun	category=verb	score=-0.5
enfuriate	category=verb	score=-0.5
enmity	category=noun	score=-0.5
enraged	category=adjective	score=-0.5
enragement	category=noun	score=-0.5
enviable	category=adjective	score=-0.5
enviably	category=adverb	score=-0.5
envious	category=adjective	score=-0.5
enviously	category=adverb	score=-0.5
enviousness	category=noun	score=-0.5
envy	category=noun	score=-0.5
envy	category=verb	score=-0.5
evil	category=adjective	score=-0.5
exacerbate	category=verb	score=-0.5
exasperate	category=verb	score=-0.5
exasperating	category=adjective	score=-0.5
exasperation	category=noun	score=-0.5
execrate	category=verb	score=-0.5
execration	category=noun	score=-0.5
frustrate	category=verb	score=-0.5
frustrated	category=adjective	score=-0.5
frustrating	category=adjective	score=-0.5
frustration	category=noun	score=-0.5
furious	category=adjective	score=-0.5
furiously	category=adverb	score=-0.5
fury	category=noun	score=-0.5
gall	category=noun	score=-0.5
galling	category=adjective	score=-0.5
get at	category=verb	score=-0.5
get to	category=verb	score=-0.5
grabby	category=adjective	score=-0.5
grasping	category=adjective	score=-0.5
gravel	category=verb	score=-0.5
greedy	category=adjective	score=-0.5
green-eyed	category=adjective	score=-0.5
green-eyed monster	category=noun	score=-0.5
grievance	category=noun	score=-0.5
grizzle	category=verb	score=-0.5
grudge	category=noun	score=-0.5
grudge	category=verb	score=-0.5
grudging	category=adjective	score=-0.5
hackles	category=noun	score=-0.5
harass	category=verb	score=-0.5
harassed	category=adjective	score=-0.5
harassment	category=noun	score=-0.5
harried	category=adjective	score=-0.5
hate	category=noun	score=-0.5
hate	category=verb	score=-0.5
hateful	category=adjective	score=-0.5
hatefully	category=adverb	score=-0.5
hatred	category=noun	score=-0.5
heartburning	category=noun	score=-0.5
high dudgeon	category=noun	score=-0.5
hostile	category=adjective	score=-0.5
hostilely	category=adverb	score=-0.5
hostility	category=noun	score=-0.5
huffily	category=adverb	score=-0.5
huffiness	category=noun	score=-0.5
huffish	category=adjective	score=-0.5
huffishness	category=noun	score=-0.5
huffy	category=adjective	score=-0.5
ill temper	category=noun	score=-0.5
ill will	category=noun	score=-0.5
incense	category=verb	score=-0.5
incensed	category=adjective	score=-0.5
indignant	category=adjective	score=-0.5
indignantly	category=adverb	score=-0.5
indignation	category=noun	score=-0.5
infuriate	category=verb	score=-0.5
infuriated	category=adjective	score=-0.5
infuriating	category=adjective	score=-0.5
infuriation	category=noun	score=-0.5
irascibility	category=noun	score=-0.5
irascible	category=adjective	score=-0.5
ire	category=noun	score=-0.5
irritate	category=verb	score=-0.5
irritated	category=adjective	score=-0.5
irritating	category=adjective	score=-0.5
irritation	category=noun	score=-0.5
jealous	category=adjective	score=-0.5
jealously	category=adverb	score=-0.5
jealousy	category=noun	score=-0.5
livid	category=adjective	score=-0.5
lividity	category=noun	score=-0.5
lividly	category=adverb	score=-0.5
loathe	category=verb	score=-0.5
loathing	category=noun	score=-0.5
mad	category=adjective	score=-0.5
maddened	category=adjective	score=-0.5
maddening	category=adjective	score=-0.5
madness	category=noun	score=-0.5
malefic	category=adjective	score=-0.5
maleficence	category=noun	score=-0.5
malevolence	category=noun	score=-0.5
malevolent	category=adjective	score=-0.5
malevolently	category=adverb	score=-0.5
malice	category=noun	score=-0.5
malicious	category=adjective	score=-0.5
maliciously	category=adverb	score=-0.5
maliciousness	category=noun	score=-0.5
malign	category=adjective	score=-0.5
malignity	category=noun	score=-0.5
misanthropic	category=adjective	score=-0.5
misanthropical	category=adjective	score=-0.5
misanthropy	category=noun	score=-0.5
misocainea	category=noun	score=-0.5
misogamy	category=noun	score=-0.5
misogynic	category=adjective	score=-0.5
misogynism	category=noun	score=-0.5
misogyny	category=noun	score=-0.5
misology	category=noun	score=-0.5
misoneism	category=noun	score=-0.5
misopedia	category=noun	score=-0.5
murderously	category=adverb	score=-0.5
murderousness	category=noun	score=-0.5
nark	category=verb	score=-0.5
nettle	category=verb	score=-0.5
nettled	category=adjective	score=-0.5
nettlesome	category=adjective	score=-0.5
odium	category=noun	score=-0.5
offend	category=verb	score=-0.5
offense	category=noun	score=-0.5
oppress	category=verb	score=-0.5
outrage	category=noun	score=-0.5
outrage	category=verb	score=-0.5
outraged	category=adjective	score=-0.5
overjealous	category=adjective	score=-0.5
peeved	category=adjective	score=-0.5
persecute	category=verb	score=-0.5
pesky	category=adjective	score=-0.5
pestered	category=adjective	score=-0.5
pestering	category=adjective	score=-0.5
pestiferous	category=adjective	score=-0.5
pique	category=noun	score=-0.5
pique	category=verb	score=-0.5
pissed	category=adjective	score=-0.5
plaguey	category=adjective	score=-0.5
plaguy	category=adjective	score=-0.5
pout	category=verb	score=-0.5
prehensile	category=adjective	score=-0.5
provoked	category=adjective	score=-0.5
quick temper	category=noun	score=-0.5
rag	category=verb	score=-0.5
rage	category=noun	score=-0.5
rancor	category=noun	score=-0.5
rancour	category=noun	score=-0.5
resentful	category=adjective	score=-0.5
resentfully	category=adverb	score=-0.5
resentment	category=noun	score=-0.5
revengefully	category=adverb	score=-0.5
rile	category=verb	score=-0.5
riled	category=adjective	score=-0.5
roiled	category=adjective	score=-0.5
scene	category=noun	score=-0.5
score	category=noun	score=-0.5
scorn	category=verb	score=-0.5
see red	category=verb	score=-0.5
short temper	category=noun	score=-0.5
sore	category=adjective	score=-0.5
spite	category=noun	score=-0.5
spiteful	category=adjective	score=-0.5
spitefulness	category=noun	score=-0.5
spleen	category=noun	score=-0.5
stew	category=verb	score=-0.5
stung	category=adjective	score=-0.5
sulk	category=verb	score=-0.5
sulkiness	category=noun	score=-0.5
sulky	category=adjective	score=-0.5
tantalize	category=verb	score=-0.5
tantrum	category=noun	score=-0.5
teasing	category=adjective	score=-0.5
temper	category=noun	score=-0.5
green-eyed monster	category=noun	score=-0.5
torment	category=noun	score=-0.5
torment	category=verb	score=-0.5
umbrage	category=noun	score=-0.5
umbrageous	category=adjective	score=-0.5
vengefully	category=adverb	score=-0.5
vengefulness	category=noun	score=-0.5
venom	category=noun	score=-0.5
vex	category=verb	score=-0.5
vexation	category=noun	score=-0.5
vexatious	category=adjective	score=-0.5
vexed	category=adjective	score=-0.5
vexing	category=adjective	score=-0.5
vindictive	category=adjective	score=-0.5
vindictively	category=adverb	score=-0.5
vindictiveness	category=noun	score=-0.5
warpath	category=noun	score=-0.5
with_hostility	category=adverb	score=-0.5
wrath	category=noun	score=-0.5
wrathful	category=adjective	score=-0.5
wrathfully	category=adverb	score=-0.5
wroth	category=adjective	score=-0.5
wrothful	category=adjective	score=-0.5
:-||	category=smiley	score=-0.5
blame	category=verb	score=-0.5
dork	category=noun	score=-0.5
scuffle	category=noun	score=-0.5
