admirable	category=adjective	score=0.5
admirably	category=adverb	score=0.5
admiration	category=noun	score=0.5
admire	category=verb	score=0.5
adoration	category=noun	score=0.5
adoring	category=adjective	score=0.5
affection	category=noun	score=0.5
affectional	category=adjective	score=0.5
affectionate	category=adjective	score=0.5
affectionateness	category=noun	score=0.5
affective	category=adjective	score=0.5
amative	category=adjective	score=0.5
amatory	category=adjective	score=0.5
amicability	category=noun	score=0.5
amicable	category=adjective	score=0.5
amicableness	category=noun	score=0.5
amicably	category=adverb	score=0.5
amorous	category=adjective	score=0.5
amorousness	category=noun	score=0.5
appreciated	category=adjective	score=0.5
approbative	category=adjective	score=0.5
approbatory	category=adjective	score=0.5
approval	category=noun	score=0.5
approve	category=verb	score=0.5
approved	category=adjective	score=0.5
approving	category=adjective	score=0.5
avid	category=adjective	score=0.5
avidity	category=noun	score=0.5
avidness	category=noun	score=0.5
banter	category=verb	score=0.5
be on cloud nine	category=verb	score=0.5
beaming	category=adjective	score=0.5
becharm	category=verb	score=0.5
belonging	category=noun	score=0.5
benefic	category=adjective	score=0.5
beneficed	category=adjective	score=0.5
beneficence	category=noun	score=0.5
beneficent	category=adjective	score=0.5
beneficially	category=adverb	score=0.5
benevolence	category=noun	score=0.5
benevolent	category=adjective	score=0.5
benevolently	category=adverb	score=0.5
bewitch	category=verb	score=0.5
bewitching	category=adjective	score=0.5
blessed	category=adjective	score=0.5
blest	category=adjective	score=0.5
blissful	category=adjective	score=0.5
blithe	category=adjective	score=0.5
blithely	category=adverb	score=0.5
blitheness	category=noun	score=0.5
bonheur	category=noun	score=0.5
brotherhood	category=noun	score=0.5
brotherlike	category=adjective	score=0.5
brotherly	category=adjective	score=0.5
calf love	category=noun	score=0.5
captivate	category=verb	score=0.5
captivated	category=adjective	score=0.5
captivating	category=adjective	score=0.5
captivation	category=noun	score=0.5
capture	category=verb	score=0.5
carefree	category=adjective	score=0.5
carefreeness	category=noun	score=0.5
caring	category=adjective	score=0.5
caring	category=noun	score=0.5
charitable	category=adjective	score=0.5
charm	category=verb	score=0.5
charmed	category=adjective	score=0.5
cheer	category=verb	score=0.5
cheer up	category=verb	score=0.5
cheerful	category=adjective	score=0.5
cheerfully	category=adverb	score=0.5
cheerfulness	category=noun	score=0.5
cheering	category=adjective	score=0.5
cheery	category=adjective	score=0.5
chipper	category=adjective	score=0.5
chirk up	category=verb	score=0.5
chirpy	category=adjective	score=0.5
cliff-hanging	category=adjective	score=0.5
comfort	category=verb	score=0.5
comfortable	category=adjective	score=0.5
comfortableness	category=noun	score=0.5
comfortably	category=adverb	score=0.5
comforting	category=adjective	score=0.5
commendable	category=adverb	score=0.5
compatibility	category=noun	score=0.5
compatible	category=adjective	score=0.5
compatibly	category=adverb	score=0.5
complacence	category=noun	score=0.5
complacency	category=noun	score=0.5
complacent	category=adjective	score=0.5
congratulate	category=verb	score=0.5
console	category=verb	score=0.5
content	category=adjective	score=0.5
content	category=verb	score=0.5
contented	category=adjective	score=0.5
contentment	category=noun	score=0.5
convivial	category=adjective	score=0.5
delighted	category=adjective	score=0.5
devoted	category=adjective	score=0.5
devotedness	category=noun	score=0.5
devotion	category=noun	score=0.5
eager	category=adjective	score=0.5
eagerly	category=adverb	score=0.5
eagerness	category=noun	score=0.5
ebullient	category=adjective	score=0.5
ebulliently	category=adverb	score=0.5
ecstatic	category=adjective	score=0.5
elan	category=noun	score=0.5
elate	category=verb	score=0.5
elated	category=adjective	score=0.5
elating	category=adjective	score=0.5
elation	category=noun	score=0.5
embolden	category=verb	score=0.5
emotive	category=adjective	score=0.5
empathetic	category=adjective	score=0.5
empathetically	category=adverb	score=0.5
empathic	category=adjective	score=0.5
empathy	category=noun	score=0.5
enamor	category=verb	score=0.5
enamoredness	category=noun	score=0.5
enamour	category=verb	score=0.5
enchant	category=verb	score=0.5
enchanting	category=adjective	score=0.5
enchantment	category=noun	score=0.5
endearingly	category=adverb	score=0.5
enjoy	category=verb	score=0.5
enthralled	category=adjective	score=0.5
enthralling	category=adjective	score=0.5
enthrallment	category=noun	score=0.5
enthusiasm	category=noun	score=0.5
enthusiastic	category=adjective	score=0.5
enthusiastically	category=adverb	score=0.5
entrance	category=verb	score=0.5
entranced	category=adjective	score=0.5
entrancing	category=adjective	score=0.5
esteem	category=noun	score=0.5
euphoria	category=noun	score=0.5
euphoriant	category=adjective	score=0.5
euphoric	category=adjective	score=0.5
exalt	category=verb	score=0.5
excellent	category=adjective	score=0.5
excitement	category=noun	score=0.5
exciting	category=adjective	score=0.5
exhilarate	category=verb	score=0.5
exhilarated	category=adjective	score=0.5
exhilarating	category=adjective	score=0.5
exhilaration	category=noun	score=0.5
exhort	category=verb	score=0.5
expansively	category=adverb	score=0.5
expectancy	category=noun	score=0.5
exuberance	category=noun	score=0.5
exuberant	category=adjective	score=0.5
exuberantly	category=adverb	score=0.5
exult	category=verb	score=0.5
exultant	category=adjective	score=0.5
exultantly	category=adverb	score=0.5
exultation	category=noun	score=0.5
exulting	category=adjective	score=0.5
exultingly	category=adverb	score=0.5
fancy	category=noun	score=0.5
fascinate	category=verb	score=0.5
fascinating	category=adjective	score=0.5
fascination	category=noun	score=0.5
favor	category=noun	score=0.5
favor	category=verb	score=0.5
favorable	category=adjective	score=0.5
favorably	category=adverb	score=0.5
favour	category=noun	score=0.5
favour	category=verb	score=0.5
favourable	category=adjective	score=0.5
favourably	category=adverb	score=0.5
festal	category=adjective	score=0.5
festive	category=adjective	score=0.5
fond	category=adjective	score=0.5
fondly	category=adverb	score=0.5
fondness	category=noun	score=0.5
fraternal	category=adjective	score=0.5
friendliness	category=noun	score=0.5
friendly	category=adjective	score=0.5
fulfil	category=verb	score=0.5
fulfill	category=verb	score=0.5
fulfillment	category=noun	score=0.5
fulfilment	category=noun	score=0.5
gaiety	category=noun	score=0.5
glad	category=adjective	score=0.5
gladden	category=verb	score=0.5
gladdened	category=adjective	score=0.5
gladfulness	category=noun	score=0.5
gladness	category=noun	score=0.5
gladsome	category=adjective	score=0.5
gladsomeness	category=noun	score=0.5
glee	category=noun	score=0.5
gleeful	category=adjective	score=0.5
gleefully	category=adverb	score=0.5
gleefulness	category=noun	score=0.5
gloat	category=noun	score=0.5
gloating	category=noun	score=0.5
gloatingly	category=adverb	score=0.5
good	category=adjective	score=0.5
good will	category=noun	score=0.5
goodwill	category=noun	score=0.5
gratified	category=adjective	score=0.5
gratify	category=verb	score=0.5
gratifying	category=adjective	score=0.5
gratifyingly	category=adverb	score=0.5
great	category=adjective	score=0.5
gusto	category=noun	score=0.5
happily	category=adverb	score=0.5
happiness	category=noun	score=0.5
happy	category=adjective	score=0.5
heart	category=noun	score=0.5
hearten	category=verb	score=0.5
high-spirited	category=adjective	score=0.5
hilarious	category=adjective	score=0.5
hilariously	category=adverb	score=0.5
hilarity	category=noun	score=0.5
identification	category=noun	score=0.5
impress	category=verb	score=0.5
infatuation	category=noun	score=0.5
insouciance	category=noun	score=0.5
inspire	category=verb	score=0.5
interest	category=verb	score=0.5
intimacy	category=noun	score=0.5
intoxicate	category=verb	score=0.5
jocularity	category=noun	score=0.5
jocund	category=adjective	score=0.5
jocundity	category=noun	score=0.5
jollity	category=noun	score=0.5
jolly	category=adjective	score=0.5
jolly	category=verb	score=0.5
jolly along	category=verb	score=0.5
jolly up	category=verb	score=0.5
jovial	category=adjective	score=0.5
joviality	category=noun	score=0.5
joy	category=noun	score=0.5
joy	category=verb	score=0.5
joyful	category=adjective	score=0.5
joyfully	category=adverb	score=0.5
joyfulness	category=noun	score=0.5
joyous	category=adjective	score=0.5
joyously	category=adverb	score=0.5
joyousness	category=noun	score=0.5
jubilance	category=noun	score=0.5
jubilancy	category=noun	score=0.5
jubilant	category=adjective	score=0.5
jubilantly	category=adverb	score=0.5
jubilate	category=verb	score=0.5
jubilation	category=noun	score=0.5
jump for joy	category=verb	score=0.5
keenness	category=noun	score=0.5
kick	category=noun	score=0.5
kindhearted	category=adjective	score=0.5
kindheartedness	category=noun	score=0.5
kindly	category=adjective	score=0.5
laudably	category=adverb	score=0.5
laughing	category=adjective	score=0.5
lift up	category=verb	score=0.5
lightheartedness	category=noun	score=0.5
lightsomeness	category=noun	score=0.5
likable	category=adjective	score=0.5
like	category=verb	score=0.5
likeable	category=adjective	score=0.5
liking	category=noun	score=0.5
lively	category=adjective	score=0.5
live up to	category=verb	score=0.5
look up to	category=verb	score=0.5
love	category=verb	score=0.5
love	category=noun	score=0.5
lovesome	category=adjective	score=0.5
loving	category=adjective	score=0.5
lovingly	category=adverb	score=0.5
lovingness	category=noun	score=0.5
loyalty	category=noun	score=0.5
merrily	category=adverb	score=0.5
merriment	category=noun	score=0.5
merry	category=adjective	score=0.5
mirth	category=noun	score=0.5
mirthful	category=adjective	score=0.5
mirthfully	category=adverb	score=0.5
mirthfulness	category=noun	score=0.5
offering protection	category=adverb	score=0.5
overjoyed	category=adjective	score=0.5
peaceful	category=adjective	score=0.5
penchant	category=noun	score=0.5
pep up	category=verb	score=0.5
perkiness	category=noun	score=0.5
perky	category=adjective	score=0.5
pick up	category=verb	score=0.5
playful	category=adjective	score=0.5
pleasant	category=adjective	score=0.5
pleased	category=adjective	score=0.5
pleasing	category=adjective	score=0.5
pleasure	category=noun	score=0.5
praiseworthily	category=adverb	score=0.5
predilection	category=noun	score=0.5
preference	category=noun	score=0.5
pride	category=noun	score=0.5
pride	category=verb	score=0.5
prideful	category=adjective	score=0.5
protective	category=adjective	score=0.5
protectively	category=adverb	score=0.5
protectiveness	category=noun	score=0.5
proudly	category=adverb	score=0.5
puppy love	category=noun	score=0.5
rapport	category=noun	score=0.5
rejoice	category=verb	score=0.5
rejoicing	category=adjective	score=0.5
rejoicing	category=noun	score=0.5
relish	category=noun	score=0.5
respect	category=noun	score=0.5
revel	category=verb	score=0.5
riotously	category=adverb	score=0.5
romantic	category=adjective	score=0.5
satiable	category=adjective	score=0.5
satisfaction	category=noun	score=0.5
satisfactorily	category=adverb	score=0.5
satisfactory	category=adjective	score=0.5
satisfiable	category=adjective	score=0.5
satisfied	category=adjective	score=0.5
satisfy	category=verb	score=0.5
satisfying	category=adjective	score=0.5
satisfyingly	category=adverb	score=0.5
schadenfreude	category=noun	score=0.5
screaming	category=adjective	score=0.5
self-complacency	category=noun	score=0.5
self-satisfaction	category=noun	score=0.5
self-satisfied	category=adjective	score=0.5
smug	category=adjective	score=0.5
smugness	category=noun	score=0.5
soft spot	category=noun	score=0.5
softhearted	category=adjective	score=0.5
softheartedness	category=noun	score=0.5
solace	category=verb	score=0.5
soothe	category=verb	score=0.5
sparkling	category=adjective	score=0.5
stimulating	category=adjective	score=0.5
sunny	category=adjective	score=0.5
suspense	category=noun	score=0.5
suspenseful	category=adjective	score=0.5
suspensive	category=adjective	score=0.5
sympathetic	category=adjective	score=0.5
sympathetically	category=adverb	score=0.5
sympathy	category=noun	score=0.5
teased	category=adjective	score=0.5
tender	category=adjective	score=0.5
tenderness	category=noun	score=0.5
thirstily	category=adverb	score=0.5
thrill	category=noun	score=0.5
thrill	category=verb	score=0.5
thrilled	category=adjective	score=0.5
tickle	category=verb	score=0.5
titillate	category=verb	score=0.5
titillated	category=adjective	score=0.5
titillating	category=adjective	score=0.5
titillation	category=noun	score=0.5
togetherness	category=noun	score=0.5
trance	category=verb	score=0.5
triumph	category=noun	score=0.5
triumph	category=verb	score=0.5
triumphal	category=adjective	score=0.5
triumphant	category=adjective	score=0.5
triumphantly	category=adverb	score=0.5
unworried	category=adjective	score=0.5
upbeat	category=adjective	score=0.5
uplift	category=verb	score=0.5
uproarious	category=adjective	score=0.5
uproariously	category=adverb	score=0.5
urge	category=verb	score=0.5
urge on	category=verb	score=0.5
walk on air	category=verb	score=0.5
wallow	category=verb	score=0.5
warm	category=adjective	score=0.5
warmhearted	category=adjective	score=0.5
warmheartedness	category=noun	score=0.5
warmth	category=noun	score=0.5
weakness	category=noun	score=0.5
with empathy	category=adverb	score=0.5
with happiness	category=adverb	score=0.5
with pride	category=adverb	score=0.5
with sympathy	category=adverb	score=0.5
worship	category=noun	score=0.5
worshipful	category=adjective	score=0.5
zeal	category=noun	score=0.5
zealous	category=adjective	score=0.5
zest	category=noun	score=0.5
zestfulness	category=noun	score=0.5
awesome	category=adjective	score=0.5
:-)	category=smiley	score=0.5
>:]	category=smiley	score=0.5
:)	category=smiley	score=0.5
:o)	category=smiley	score=0.5
:]	category=smiley	score=0.5
:c)	category=smiley	score=0.5
:>	category=smiley	score=0.5
=]	category=smiley	score=0.5
=)	category=smiley	score=0.5
:}	category=smiley	score=0.5
:^)	category=smiley	score=0.5
>:D	category=smiley	score=0.5
:-D	category=smiley	score=0.5
:D	category=smiley	score=0.5
=-D	category=smiley	score=0.5
=D	category=smiley	score=0.5
8-)	category=smiley	score=0.5
:-))	category=smiley	score=0.5
proud	category=adjective	score=0.5
vibrant	category=adjective	score=0.5
amazing	cateoory=adjective	score=0.5
inspiring	category=adjective	score=0.5
fabulous	category=adjective	score=0.5
celebrate	category=verb	score=0.5
inspiration	category=noun	score=0.5
kudos	category=noun	score=0.5
celebration	category=noun	score=0.5
celebrated	category=adjective	score=0.5
care	category=verb	score=0.5
endorse	category=verb	score=0.5
hero	category=noun	score=0.5
superb	category=adjective	score=0.5
welcome	category=verb	score=0.5
