Weltschmerz	category=noun	score=-0.5
aggrieve	category=verb	score=-0.5
attrition	category=noun	score=-0.5
bad	category=adjective	score=-0.5
bereaved	category=adjective	score=-0.5
bereft	category=adjective	score=-0.5
bored	category=adjective	score=-0.5
brokenheartedness	category=noun	score=-0.5
cast down	category=verb	score=-0.5
cheerless	category=adjective	score=-0.5
cheerlessly	category=adverb	score=-0.5
cheerlessness	category=noun	score=-0.5
compunction	category=noun	score=-0.5
contrite	category=adjective	score=-0.5
contritely	category=adverb	score=-0.5
contriteness	category=noun	score=-0.5
contrition	category=noun	score=-0.5
deject	category=verb	score=-0.5
demoralising	category=adjective	score=-0.5
demoralization	category=noun	score=-0.5
demoralize	category=verb	score=-0.5
demoralized	category=adjective	score=-0.5
demoralizing	category=adjective	score=-0.5
deplorable	category=adjective	score=-0.5
deplorably	category=adverb	score=-0.5
depress	category=verb	score=-0.5
depressed	category=adjective	score=-0.5
depressing	category=adjective	score=-0.5
depression	category=noun	score=-0.5
depressive	category=adjective	score=-0.5
desolate	category=adjective	score=-0.5
desolation	category=noun	score=-0.5
despairingly	category=adverb	score=-0.5
despondence	category=noun	score=-0.5
despondency	category=noun	score=-0.5
despondent	category=adjective	score=-0.5
despondently	category=adverb	score=-0.5
dingy	category=adjective	score=-0.5
disconsolate	category=adjective	score=-0.5
disconsolateness	category=noun	score=-0.5
discouraged	category=adjective	score=-0.5
disheartened	category=adjective	score=-0.5
disheartening	category=adjective	score=-0.5
dismal	category=adjective	score=-0.5
dismay	category=verb	score=-0.5
dispirit	category=verb	score=-0.5
dispirited	category=adjective	score=-0.5
dispiritedness	category=noun	score=-0.5
dispiriting	category=adjective	score=-0.5
distressed	category=adjective	score=-0.5
doleful	category=adjective	score=-0.5
dolefully	category=adverb	score=-0.5
dolefulness	category=noun	score=-0.5
dolor	category=noun	score=-0.5
dolorous	category=adjective	score=-0.5
dolour	category=noun	score=-0.5
dolourous	category=adjective	score=-0.5
downcast	category=adjective	score=-0.5
downhearted	category=adjective	score=-0.5
downheartedness	category=noun	score=-0.5
downtrodden	category=adjective	score=-0.5
drab	category=adjective	score=-0.5
drear	category=adjective	score=-0.5
dreary	category=adjective	score=-0.5
dysphoria	category=noun	score=-0.5
dysphoric	category=adjective	score=-0.5
execrable	category=adjective	score=-0.5
forlorn	category=adjective	score=-0.5
forlornly	category=adverb	score=-0.5
forlornness	category=noun	score=-0.5
gloom	category=noun	score=-0.5
gloomful	category=adjective	score=-0.5
gloomily	category=adverb	score=-0.5
gloominess	category=noun	score=-0.5
glooming	category=adjective	score=-0.5
gloomy	category=adjective	score=-0.5
glum	category=adjective	score=-0.5
godforsaken	category=adjective	score=-0.5
grief	category=noun	score=-0.5
grief-stricken	category=adjective	score=-0.5
grieve	category=verb	score=-0.5
grieving	category=adjective	score=-0.5
grievous	category=adjective	score=-0.5
grievously	category=adverb	score=-0.5
grim	category=adjective	score=-0.5
guilt	category=noun	score=-0.5
guilt feelings	category=noun	score=-0.5
guilt trip	category=noun	score=-0.5
guilty	category=adjective	score=-0.5
guilty conscience	category=noun	score=-0.5
hangdog	category=adjective	score=-0.5
hapless	category=adjective	score=-0.5
harass	category=verb	score=-0.5
heartache	category=noun	score=-0.5
heartbreak	category=noun	score=-0.5
heartbreaking	category=adjective	score=-0.5
heartrending	category=adjective	score=-0.5
heartsick	category=adjective	score=-0.5
heartsickness	category=noun	score=-0.5
heavyhearted	category=adjective	score=-0.5
heavyheartedness	category=noun	score=-0.5
helplessness	category=noun	score=-0.5
joyless	category=adjective	score=-0.5
joylessly	category=adverb	score=-0.5
joylessness	category=noun	score=-0.5
lachrymose	category=adjective	score=-0.5
laden	category=adjective	score=-0.5
lamentably	category=adverb	score=-0.5
loneliness	category=noun	score=-0.5
long-faced	category=adjective	score=-0.5
lorn	category=adjective	score=-0.5
low-spirited	category=adjective	score=-0.5
low-spiritedness	category=noun	score=-0.5
melancholic	category=adjective	score=-0.5
melancholy	category=adjective	score=-0.5
melancholy	category=noun	score=-0.5
miserable	category=adjective	score=-0.5
miserably	category=adverb	score=-0.5
misery	category=noun	score=-0.5
misfortunate	category=adjective	score=-0.5
mournful	category=adjective	score=-0.5
mournfully	category=adverb	score=-0.5
mournfulness	category=noun	score=-0.5
mourning	category=adjective	score=-0.5
oppress	category=verb	score=-0.5
oppressed	category=adjective	score=-0.5
oppression	category=noun	score=-0.5
oppressive	category=adjective	score=-0.5
oppressively	category=adverb	score=-0.5
oppressiveness	category=noun	score=-0.5
pathetic	category=adjective	score=-0.5
penance	category=noun	score=-0.5
penitence	category=noun	score=-0.5
penitent	category=adjective	score=-0.5
penitentially	category=adverb	score=-0.5
penitently	category=adverb	score=-0.5
persecute	category=verb	score=-0.5
persecuted	category=adjective	score=-0.5
piteous	category=adjective	score=-0.5
pitiable	category=adjective	score=-0.5
pitiful	category=adjective	score=-0.5
pitying	category=adjective	score=-0.5
plaintive	category=adjective	score=-0.5
plaintively	category=adverb	score=-0.5
plaintiveness	category=noun	score=-0.5
poor	category=adjective	score=-0.5
regret	category=noun	score=-0.5
regret	category=verb	score=-0.5
regretful	category=adjective	score=-0.5
remorse	category=noun	score=-0.5
remorseful	category=adjective	score=-0.5
remorsefully	category=adverb	score=-0.5
repent	category=verb	score=-0.5
repentance	category=noun	score=-0.5
repentant	category=adjective	score=-0.5
repentantly	category=adverb	score=-0.5
rue	category=verb	score=-0.5
rueful	category=adjective	score=-0.5
ruefully	category=adverb	score=-0.5
ruefulness	category=noun	score=-0.5
ruthfulness	category=noun	score=-0.5
sad	category=adjective	score=-0.5
sadden	category=verb	score=-0.5
saddening	category=adjective	score=-0.5
sadly	category=adverb	score=-0.5
sadness	category=noun	score=-0.5
self-pity	category=noun	score=-0.5
self-reproach	category=noun	score=-0.5
shamed	category=adjective	score=-0.5
shamefaced	category=adjective	score=-0.5
somberness	category=noun	score=-0.5
sorrow	category=noun	score=-0.5
sorrowful	category=adjective	score=-0.5
sorrowfully	category=adverb	score=-0.5
sorrowfulness	category=noun	score=-0.5
sorrowing	category=adjective	score=-0.5
suffering	category=adjective	score=-0.5
tearful	category=adjective	score=-0.5
tearfulness	category=noun	score=-0.5
tyrannical	category=adjective	score=-0.5
tyrannous	category=adjective	score=-0.5
uncheerful	category=adjective	score=-0.5
uncheerfulness	category=noun	score=-0.5
unhappiness	category=noun	score=-0.5
unhappy	category=adjective	score=-0.5
weepiness	category=noun	score=-0.5
weeping	category=adjective	score=-0.5
woe	category=noun	score=-0.5
woebegone	category=adjective	score=-0.5
woeful	category=adjective	score=-0.5
woefully	category=adverb	score=-0.5
woefulness	category=noun	score=-0.5
world-weariness	category=noun	score=-0.5
world-weary	category=adjective	score=-0.5
wretched	category=adjective	score=-0.5
:-(	category=smiley	score=-0.5
>:[	category=smiley	score=-0.5
:-(	category=smiley	score=-0.5
:(	category=smiley	score=-0.5
:-c	category=smiley	score=-0.5
:c	category=smiley	score=-0.5
:-<	category=smiley	score=-0.5
:<	category=smiley	score=-0.5
:-[	category=smiley	score=-0.5
:[	category=smiley	score=-0.5
:{	category=smiley	score=-0.5
>.>	category=smiley	score=-0.5
<.<	category=smiley	score=-0.5
>.<	category=smiley	score=-0.5
failed	category=adjective	score=-0.5
heartbroken	category=adjective	score=-0.5
_._	category=smiley	score=-0.5
loss	category=noun	score=-0.5
lost	category=adjective	score=-0.5
hunger	category=noun	score=-0.5
hungry	category=adjective	score=-0.5
malnutrition	category=noun	score=-0.5
